Xu, Xu, Xu, Xu, Xu, Xu, Xu, Xu, Xu, Xu, Xu, Xu, Xu, Xu, Xu, Xu, Xu, Xu, Xuc, Uu, Uu^Br/, Xu, Xu
Xu, Xu, Xoa, Xoa, Xoa, Xu, Xu, Xoa, Xoa, Xu, Xu, Xue, Xoa, Xu, Xoa, Xu, Xu, Xu, Uu^Br/, Uu^Xo, Xuc, Xuc, Xu
Xu, Xoa, Uh, Uh, Uu^Es, Uu^Es, Uu^Em, Uu^Es, Uu^Es, Xu, Qxu, Uu^Vu, Qxu, Xoa, Qxu, Xu, Xu, Xu, Uu^Br|, Uh, Uh, Xu, Xu
Xu, Xu, Xu, Uu^Vud, Uu^Es, Cud, 3 Kud, Cud, Qxu, Qxu, Qxu, Qxu^Bs|, Uu^Em, Qxu, Qxu^Bs/, Uu^Es, Uu^Br/, Uu^Br/, Uu^Es, Uu^Es, Xu, Xu, Xu
Xu, Xu, Xu, Xoa, Uu^Es, Cud, Cud, Cud^Edb, Ur^Es, Qxu, Uh, Uu^Es, Ur^Es, Qxu^Bs/, Qxu, Uu^Br/, Uh, Uu^Es, Uh, Xu, Xu, Xu, Xu
Xu, Xu, Xoa, Xoa, Xu, Uu, Uu^Em, Qxu, Qxu, Uh, Uu^Br\, Uu^Vud, Uu^Br/, Qxu, Uu, Uu, Ur^Em, Uh, Xu, Xue, Xu, Xu, Xu
Xu, Xu, Uu^Xo, Uu^Xo, Uu^Br\, Uh, Uu^Br/, Qxu, Qxu, Uu^Br/, Uh, Uu^Br\, Ker, Cer, Uh^Eb, Uu^Em, Uu^Em, Uh, Uu, Uu^Em, Xu, Xu, Xu
Xu, Xu, Xu, Xu, Ur^Es, Uu^Br/, Uu^Em, Qxu, Qxu, Uu^Es, Ur^Es, Uu, Qxu, Cer, Ur^Es, Ur^Es, Uu, Uu, Ur^Es, Uu^Vu, Xu, Xu, Xu
Xu, Xu, Xuc, Xu, Uu^Br/, Uu^Br|, Uu^Em, Qxu^Bcx\, Ur^Es, Uu^Es, Uu^Em, Qxu, Ur^Em, Uu, Xu, Uu, Xu, Uh, Uu, Uu^Edb, Xue, Xu, Xu
Xoa, Xuc, Uu^Xo, Uu^Br/, Uh, Uh, Ur^Es, Qxu, Uh, Uu^Es, Qxu^Bcx\, Qxu, Uu^Es, Xu, Uu, Xu, Uh, Xu, Xu, Xu, Xu, Xu, Xu
Xuc, Uu^Br/, Xuc, Xoa, Xu, Xu, Qxu, Qxu, Qxu^Bs|, Qxu, Xu, Uh, Xu, Ur^Es, Xu, Uu, Uu^Edb, Uu^Vu, Xu, Xu, Xu, Xu, Xu
Uu^Br/, Uu^Br|, Xoa, Xu, Xu, Xue, Xu, Uh^Emf, Uu^Vud, Xu, Uu^Vu, Uh, Uh, Uu, Ur^Em, Uu^Es, Xu, Xu, Xu, Xu, Xu, Xu, Xu
Xoa, Xuc, Xu, Xu, Uu^Vu, Uh^Es, Uh^Es, Xu, Xu, Xu, Ur^Es, Uu^Edb, Uh, Uu^Es, Uu^Es, Ur^Edb, Uu^Es, Xu, Uu^Es, Xu, Xu, Xu, Xu
Xu, Xu, Xu, Uh^Es, Uu^Edb, Ur^Es, Uu^Es, Uu^Em, Uu^Es, Uu^Es, Xu, Xu, Uh, Xu, Ur^Es, Uu^Es, Uh^Ecf, Cer, Cer, Uu^Es, Uu^Vu, Xu, Xu
Xu, Xu, Uh^Em, Uh^Es, Uu^Ii, Uh^Es, Xu, Ur^Em, Uh, Xu, Xu, Xu, Xu, Uu, Xu, Cer, Cer, 1 Ker, Cer, Uu, Uu, Uu^Ii, Xu
Xu, Xu, Xu, Uu^Edb, Ur^Es, Uu^Edb, Uu^Es, Uu^Em, Xu, Uh, Xu, Xu, Xu, Xu, Uu, Uu, Uu, Uu, Uu, Uu^Ii, Uu^Ii, Uu^Ii, Uu^Ii
Xu, Xu, Xu, Uh^Es, Xu, Uh, Xu, Uh, Xu, Xu, Xu, Xu, Xu, Uu, Uu, Uu, Uu, Uu^Ii, Uu^Ii, Uu^Esa, Uu^Esa, Uu^Esa, Uu^Ii
