Xu, Xu, Xu, Xu, Xu, Xu, Xu, Xu, Xu, Xu, Xu, Xu, Xu, Xu, Xu, Xu, Xu, Xu, Xuc, Uu, Uu^Br/, Xu, Xu
Xu, Xu, Xoa, Xoa, Xoa, Xu, Xu, Xoa, Xoa, Xu, Xu, Xue, Xoa, Xu, Xoa, Xu, Xu, Xu, Uu^Br/, Uu^Br/, Xuc, Xuc, Xu
Xu, Xoa, Uh, Uh, Uu^Es, Uu^Es, Uu^Em, Uu^Es, Uu^Es, Xu, Qxu, Uu^Emf, Qxu, Xoa, Qxu, Xu, Xu, Xu, Uu^Br|, Uh, Uh, Xu, Xu
Xu, Xu, Xu, Uu^Vud, Uu^Es, Cud, 1 Kud^Ebn, Cud, Qxu, Qxu, Qxu, Qxu^Bs|, Uu^Em, Qxu, Qxu^Bs/, Uu^Es, Uu^Br/, Uu^Br/, Uu^Es, Uu^Es, Xu, Xu, Xu
Xu, Xu, Xu, Xoa, Uu^Es, Cud, Cud, Cud^Edb, Ur^Es, Qxu, Uh, Uu^Es, Ur^Es, Qxu^Bs/, Qxu, Uu^Br/, Uh, Uu^Es, Uh, Xu, Xu, Xu, Xu
Xu, Xu, Xoa, Xoa, Xu, Uu, Uu^Em, Qxu, Qxu, Uh, Uu^Br\, Uu^Vud, Uu^Br/, Qxu, Uu, Uu, Ur^Em, Uh, Xu, Xue, Xu, Xu, Xu
Xu, Xu, Uu^Xo, Uu^Xo, Uu^Br\, Uh, Uu^Br/, Qxu, Qxu, Uu^Br/, Uh, Uu^Br\, Ke, Ce, Uh^Ebn, Uu^Em, Uu^Em, Uh, Uu^Em, Uu^Emf, Xu, Xu, Xu
Xu, Xu, Xu, Xu, Ur^Es, Uu^Br/, Uu^Em, Qxu, Qxu, Uu^Es, Ur^Es, Uu, Qxu, Ce, Ur^Es, Ur^Es, Uu, Uu, Ur^Em, Uu^Vhr, Xu, Xu, Xu
Xu, Xu, Xuc, Xu, Uu^Br/, Uu^Br|, Uu^Em, Qxu^Bcx\, Ur^Es, Uu^Es, Uu^Em, Qxu, Ur^Em, Uu, Xu, Uu, Xu, Uh, Uu^Vhr, Uu^Emf, Xue, Xu, Xu
Xoa, Xuc, Uu^Xo, Uu^Br/, Uh, Uh, Ur^Es, Qxu, Uh, Uu^Es, Qxu^Bcx\, Qxu, Rr^Pw/o, Xu, Uu^Edb, Xu, Uh, Xu, Xu, Xu, Xu, Xu, Xu
Xuc, Uu^Br/, Xuc, Xoa, Xu, Xu, Qxu, Qxu, Qxu^Bs|, Qxu, Xu, Rr^Pw/o, Uu, Ur^Edb, Uu^Edb, Uu, Uu^Edb, Uu^Vu, Xu, Xu, Xu, Xu, Xu
Uu^Br/, Uu^Br|, Xoa, Xu, Xu, Xue, Xu, Uh^Emf, Uu^Vud, Xu, Uu^Vu, Uh, Uh, Uu, Ur^Em, Uu^Es, Xu, Xu, Xu, Xu, Xu, Xu, Xu
Xoa, Xuc, Xu, Xu, Uu^Vu, Uh^Es, Uh^Es, Xu, Xu, Xu, Ur^Es, Uu^Edb, Uh, Uu^Es, Uu^Es, Ur^Edb, Uu^Es, Xu, Uu^Es, Xu, Xu, Xu, Xu
Xu, Xu, Xu, Uh^Es, Uu^Edb, Ur^Es, Uu^Es, Uu^Em, Uu^Es, Uu^Es, Xu, Xu, Uh, Xu, Ur^Es, Uu^Es, Uh^Ecf, Cer, Cer, Uu^Es, Uu^Vu, Xu, Xu
Xu, Xu, Uh^Em, Uh^Es, 2 Uu^Ii, Uh^Es, Xu, Ur^Em, Uh, Xu, Xu, Xu, Xu, Uu, Xu, Cer, Cer, 3 Ker, Cer, Uu, Uu, Uu^Ii, Xu
Xu, Xu, Xu, Uu^Edb, Ur^Es, Uu^Edb, Uu^Es, Uu^Em, Xu, Uh, Xu, Xu, Xu, Xu, Uu, Uu, Uu, Uu, Uu, Uu^Ii, Uu^Ii, Uu^Ii, Uu^Ii
Xu, Xu, Xu, Uh^Es, Xu, Uh, Xu, Uh, Xu, Xu, Xu, Xu, Xu, Uu, Uu, Uu, Uu, Uu^Ii, Uu^Ii, Uu^Esa, Uu^Esa, Uu^Esa, Uu^Ii
