Uu, Gs^Fp, Xu, Gg, Xu, Gg, Ms, Aa, Ww, Ai, Ww, Ww, Gg^Efm, Gg, Rr, Gg, Gg, Gg, Gll, Gg, Gg, Gg, Gs^Fp, Gs^Fp, Ss, Ss, Gg, Gs^Fp, Gs^Fp, Rr, Gg, Gg, Gg, Gg, Gs^Fp, Gs^Fp, Gll, Gg, Hh, Hh, Gs^Fp, Gg
Uu^Dr, Xu, Xu, Xu, Ms^Xm, Ms^Xm, Aa^Esa, Aa, Ww, Ai, Ww, Ww, Gg^Em, Gg^Em, Rp, Gs^Fp, Gs^Fp, Gs^Fp, Gg, Gg, Cv, Gs^Fp, Gg^Ve, Ss, Ds^Em, Ss, Gs^Fp, Gs^Fp, Gg, Rr, Gg, Gs, Gg^Es, Gg, Gs^Fp, Gs^Fp, Aa, Gg^Efm, Gg^Ve, Gs^Fp, Gs^Fp, Gg
Xu, Ur^Dr, Uu, Xu, Xu, Ms, Ms, Ha^Es, Ai, Ww, Ww, Ww, Ww, Ww^Ewl, Rp, Gs^Fp, Gg^Ve, Gs^Fp, Gs^Fp, Kv, Cv, Gs^Fp, Gs^Efm, Gs^Fp, Gs^Fp, Ds^Es, Gg, Gg^Em, Rra, Rr, Aa, Gg, Gg, Gg, Gs^Fp, Aa^Fpa, Aa^Fpa, Gs^Fp, Gs^Fp, Gs^Fp, Gg^Efm, Gg
Xu, Uu, Ur^Es, Uh^Em, Xu, Ha, Ms, Ha, Ha, Ww, Ww, Ww, Ww^Ewl, Rp, Gs^Fp, Gs^Fp, Gs^Fp, Gs^Fp, Gs^Fp, Gg^Ecf, Gg^Efm, Gg, Gg, Gg, Gll, Gg, Gg, Gg, Rra, Aa, Aa^Fpa, Aa^Fpa, Gg, Gs, Aa^Fpa, Cea, Cea, Cea, Gs^Fp, Gs^Fp, Gg^Efm, Gg^Efm
Xu, Tb^Tf, Uu, Uu, Xu, Mm, Ha, Ha^Edb, Hh, Aa^Fpa, Hh^Es, Hh, Rp, Rp, Gs^Fp, Gs^Fp, Gg^Efm, Gg^Efm, Gg, Gg, Gg, Gg, Hh^Es, Gg, Gg, Gg, Gs, Gg, Aa, Rra, Aa^Esa, Ha, Gg, Aa, Aa^Fpa, Cea, 2 Kea, Cea, Aa^Fpa, Aa, Gg, Gs^Fp
Xu, Uh^Em, Uu, Ur^Es, Rp, Mm^Xm, Mm, Ha^Vhha, Ha, Hh, Hh, Rp, Rp, Gg, Gs, Gg, Gg, Gg, Gg, Gll, Gg, Gg, Gg, Gg^Es, Gg, Aa, Aa, Aa, Aa, Rra, Aa, Aa^Fpa, Gg^Ve, Gs^Fp, Cea, Cea^Ecf, Cea, Aa^Fpa, Gs^Fp, Aa, Gg, Gs^Fp
Xu, Xu, Xu, Uu, Gg, Rp, Ms, Ms, Ms^Xm, Hh, Hh^Es, Rr, Gg, Gg, Gg, Gg, Gg, Gg, Gg, Gg^Vh, Gg, Gg, Gg, Gg, Gg, Aa, Aa^Esa, Gg, Gg, Rra, Rb^Gvs, Gs^Fp, Gs^Fp, Aa^Fpa, Aa^Fpa, Rra, Aa^Fpa, Aa^Fpa, Gg, Gg, Gg, Gg
Mm, Mm^Xm, Mm^Xm, Gg, Gg, Rd, Rp, Ms, Ms, Ms, Hh, Rp, Gg, Gg^Es, Gg, Hh, Aa^Fpa, Ha, Ha, Gg, Gg^Em, Hh, Hh, Ms, Ha, Aa^Fpa, Aa, Gg^Vwm, Gg, Rp, Rb^Gvs, Rb^Gvs, Rb^Gvs, Gs^Fp, Rp, Rra, Gs^Fp, Gs^Fp, Gg^Vh, Gg, Gg, Hh
Mm, Mm, Mm^Xm, Mm^Xm, Gs^Fp, Gs^Fp, Rd, Mm, Hh, Hh, Gs^Fp, Rr, Gg, Gll, Gs, Gg, Hh, Ha, Aa^Fpa, Ha, Hh, Hh, Hh, Hh, Hh, Ms, Ha, Gg, Rr, Rr, Rb^Gvs, Rb^Gvs, Rr, Rp, Gg, Gg, Gg, Gs^Fp, Gg, Gg, Gg, Gg
Mm, Mm, Mm, Mm, Hh, Rd, Hh, Gg, Gg, Ds, Ds^Esd, Rr, Gg^Vh, Gg, Gg, Hh, Hh, Ha, Aa^Fpa, Aa^Fpa, Ha, Hh^Es, Mm, Mm^Xm, Mm, Ms, Hh, Gg, Rp, Gg^Vh, Rr, Rr, Gg, Gg, Gg, Gs, Gg, Gg, Gs^Fp, Gll, Gg, Hh
Gs^Fp, Mm^Xm, Hh, Hh^Es, Hh, Rp, Rd, Gg, Rp, Rr, Rp, Rp, Gg, Gg, Gg, Gg, Hh, Hh, Ha, Aa^Fpa, Ha, Hh, Hh, Mm, Hh, Hh, Rp, Rp, Rr, Rp, Gg, Gg^Eff, Gg^Eff, Gg, Gg^Es, Gg, Gg, Gs^Fp, Gs^Fp, Gg, Gg, Aa
Gs^Fp, Mm, Hh, Hh, Gs^Fp, Hh, Rp, Rr, Gg, Gg, Gg, Gs, Gg, Gg^Es, Gg, Gll, Gg, Ha, Aa^Esa, Ha, Ha^Vhha, Ms, Hh, Hh, Ha, Hh, Rr, Rp, Gg^Es, Gg, Gg^Vh, Gg, Gg, Gg^Eff, Gg^Eff, Gg, Gs^Fp, Gs^Fp, Gs^Fp, Gg, Gg, Aa
Hh, Hh^Es, Hh, Gg, Rr, Rp, Gs, Gg, Gs, Gg^Es, Gg, Gg, Gg, Gg, Gg, Gg, Gg, Aa, Aa, Gg, Gg, Hh, Hh, Ms, Hh, Ms, Rr, Rr, Rp, Ds, Ww, Gs^Fp, Gg, Gg, Gg, Gs^Fp, Gg, Gs^Fp, Gs^Fp, Gg, Gg, Aa
Hh, Hh, Gg, Gg, Rp, Gg, Gg, Gg, Gg, Gg, Hh^Es, Hh, Hh, Hh, Hh, Gg, Aa, Aa, Aa, Gg, Gg, Gg, Hh, Hh, Gg, Rp, Gg, Gg, Rr, Ds^Esd, Ww, Ds, Gg, Gg, Gs^Fp, Gs^Fp, Gg^Efm, Gg^Efm, Gs^Fp, Gs^Fp, Gg^Ve, Gg
Hh, Gg, Gs, Gg, Rr, Gg, Gg, Gg, Gg, Hh^Es, Hh^Es, Hh, Hh, Hh^Es, Gg, Gg, Gg, Gg, Gs, Gg, Gg, Gs^Fp, Gs^Fp, Gs^Fp, Gs^Fp, Rp, Gg, Gg, Rr, Ds, Ds^Esd, Ds, Gg, Gg, Gs^Fp, Gs^Fp, Cv, Cv, Cv, Gs^Fp, Gs^Fp, Gg
Gg, Gg, Gg, Gg, Rp, Gs^Fp, Gs^Fp, Gs^Fp, Gg, Hh, Hh, Ha, Ha, Hh, Gg^Ecf, Gg, Gg, Gg, Gg, Gg, Gg^Efm, Gs^Fp, Aa^Vea, Aa^Fpa, Aa^Fpa, Rra, Gg, Rr, Gg, Gg, Gs^Fp, Gs^Fp, Gg, Gg, Gg, Gs^Fp, Gs^Fp, 4 Kv, Cv, Gg^Efm, Gs^Fp, Gs^Fp
Gg, Gg, Gs, Gg, Rp, Gs^Fp, Gs^Fp, Gs^Fp, Gs^Fp, Gs^Fp, Ha, Ha, Aa^Fpa, Cv, Kv, Cv, Gs^Fp, Gs^Fp, Gs^Fp, Gs^Fp, Gg^Efm, Gs^Fp, Gs^Fp, Aa^Fpa, Aa^Fma, Rra, Gg^Vh, Rp, Gg, Gg, Gg^Vh, Gg, Gs, Gg, Gg, Gg, Gs^Fp, Gs^Fp, Gg, Gg^Efm, Gs^Fp, Gs^Fp
Gg, Gg, Gg, Gg, Rp, Gs^Fp, Gg^Efm, Gg, Gs^Fp, Aa^Vea, Aa^Fpa, Aa^Fpa, Aa^Fpa, Aa^Fpa, Cv, Gs^Fp, Gg^Ve, Gs^Fp, Hh, Hh, Mm^Xm, Mm, Hh^Es, Hh, Gs^Fp, Rra, Rra, Rr, Gg, Gs, Gg, Gg, Gg, Gg^Es, Gll, Gg, Gg, Gg, Gs^Fp, Gs^Fp, Gs^Fp, Gs^Fp
Gg, Aa, Gg, Rp, Gg, Gs^Fp, Gg, Gg^Efm, Gs^Fp, Gs^Fp, Gs^Fp, Aa^Fpa, Gs^Fp, Aa^Fpa, Gg, Gs^Fp, Gs^Fp, Hh, Mm, Mm, Mm, Mm, Mm, Mm, Hh, Hh, Rr, Rr, Rp, Gg, Gg, Hh^Es, Gg, Gg, Gg, Hh^Es, Gg, Gs^Fp, Gs^Fp, Gg^Efm, Gs^Fp, Gs^Fp
Aa, Aa, Gg, Rp, Gg, Gs^Fp, Gg^Efm, Gg, Gg, Gs^Fp, Gs^Fp, Gg, Gll, Gg, Gg, Gg^Efm, Gs^Fp, Hh, Hh^Es, Hh^Dr, Hh^Es, Mm, Mm, Mm, Hh, Mm, Rr, Gg, Rp, Gs^Fp, Gg, Gg, Gg, Gg, Hh^Es, Hh, Gs^Fp, Gs^Fp, Gs^Fp, Gs^Fp, Gs^Fp, Gg
Ww, Aa, Rp, Rp, Ww, Gs^Fp, Ww, Ww, Ww, Gs^Fp, Ww, Gg, Gg, Gg, Gs^Fp, Gs^Fp, Gs^Fp, Hh, Mm, Hh, Mm, Hh, Hh, Hh^Es, Mm^Xm, Hh, Rp, Gg, Rp, Gg, Gg, Gll, Gg, Gg, Gg, Gg, Gs^Fp, Hh, Hh, Gs^Fp, Mm, Mm
Aa, Ww, Ww, Ww^Bw\, Gg, Ww, Ww, Ww, Gs^Fp, Ww, Ww, Ww, Ww, Gs^Fp, Gs^Fp, Gg^Efm, Ww, Hh, Mm, Mm^Xm, Mm, Hh^Vhh, Mm, Mm, Mm, Hh, Rp, Rr, Gs^Fp, Gs^Fp, Gs^Fp, Gs^Fp, Gg, Gg, Gs, Gg, Gg, Hh, Hh, Mm, Mm, Mm
Aa^Esa, Aa, Ww, Ww, Ww^Bw|, Ww, Gll, Gg, Gs^Fp, Gs^Fp, Gs, Gg, Gg, Ww, Ww, Ww, Ai, Ww, Ai, Mm, Mm, Mm, Mm, Mm, Mm, Mm, Rp, Rp, Gs^Fp, Gg^Ve, Gs^Fp, Gs^Fp, Hh, Gg, Aa^Es, Gg, Gg, Gg, Gs^Fp, Mm, Mm^Xm, Mm
Aa, Aa, Gg, Gg, Rra, Aa, Aa, Gg, Gs^Fp, Gg, Gg, Gg^Es, Gg^Vh, Gs^Fp, Gg, Ww, Ww, Ww, Ha, Ha, Ms, Mm, Ms^Xm, Ms, Ms, Hh^Es, Rra, Rra, Hh, Gs^Fp, Hh, Hh, Hh, Hh, Gg, Gg, Gg, Hh, Hh^Vhh, Mm, Mm, Mm
Aa, Ha, Hh, Gg, Rra, Aa^Esa, Aa, Gg, Hh, Hh, Gg, Gg, Gg, Gs^Fp, Gg, Hh, Ww, Ww, Ai, Ha, Ms, Ms, Ms, Ms, Ms, Ha, Rra, Rra, Gg, Hh, Mm, Mv, Mm, Hh, Gs, Gll, Hh, Hh, Hh, Mm, Mm, Mm
Hh, Mm, Hh, Gg, Rra, Aa, Aa, Gg, Hh, Ha, Aa^Fpa, Aa^Fpa, Aa^Fpa, Gg, Gg, Gs, Aa, Ai, Aa^Fpa, Ha, Aa^Fpa, Ha, Ms, Ms, Ms, Ha, Aa^Esa, Aa, Rra, Hh, Hh, Mm, Mm, Hh, Gg, Gg, Gg, Gg, Aa, Mm, Mm, Mm
Mm, Mm, Mm, Hh, Rra, Gs, Gg, Gs, Gg, Ha, Ha, Ha, Aa, Gg, Gg^Es, Gs, Aa, Aa, Aa^Fpa, Aa^Fpa, Ha, Ha^Es, Ha, Ha, Hh, Gg, Rra, Rra, Rra, Gg, Hh, Hh, Hh, Hh, Gs^Fp, Gs^Fp, Gg, Gg, Gg, Gg, Gg, Mm
Mm^Xm, Mm, Hh, Hh, Gg, Rra, Gg, Gg, Gg, Gs, Ha, Aa^Esa, Aa, Aa, Gs, Gg, Aa, Aa^Fpa, Aa, Aa, Gg, Gg, Gg, Gs, Rp, Rra, Gg, Gg, Rra, Aa^Esa, Hh, Hh, Hh, Gg^Vh, Gs, Gg, Gs^Fp, Gg, Gg, Gg, Gg, Gg
Mm, Mm, Hh, Hh, Hh, Rp, Gs^Fp, Gs^Fp, Gg, Hh, Ha, Ha, Aa, Aa, Aa, Aa, Aa, Aa^Esa, Aa, Aa, Aa, Gs, Rp, Rr, Gs^Fp, Gs^Fp, Gs^Fp, Gs^Fp, Rr, Gg, Gg, Hh, Gs^Fp, Gg, Gg, Gs, Gs^Fp, Gs^Fp, Gg, Gg, Ww, Ww
Hh, Hh, Hh, Gg, Rp, Rp, Gs, Gs^Fp, Hh, Hh, Hh^Es, Hh, Aa^Vha, Aa, Rra, Aa, Rra, Gg, Gg^Vh, Gg, Gs, Gg, Rr, Gg, Gs^Fp, Gs^Fp, Gg^Ve, Rp, Gs^Fp, Re, Gg, Gg, Gs^Fp, Gg, Ww, Ww, Ww, Gg^Vh, Ww, Ww, Gg, Aa
Aa, Aa, Aa, Gg, Rra, Gs^Fp, Gs^Fp, Gs^Fp, Aa^Fpa, Ha, Ha, Hh, Hh, Rra, Aa, Rra, Gg, Rr, Rr, Rp, Rr, Rp, Gg, Gs^Fp, Gs^Fp, Gg, Rp, Rr, Gs^Fp, Re, Gll, Re, Ww^Bw\r, Ww, Gs^Fp, Ww, Ww, Ww, Gg, Gg, Gg, Aa
Gg, Gg, Aa, Gs, Aa, Rra, Aa^Fpa, Hh, Ha, Ha, Ha^Es, Hh^Es, Gs^Fp, Rr, Gg, Gs, Gg, Gg, Gs^Fp, Hh, Hh, Hh, Gg, Gs^Fp, Rr, Rp, Gg, Gg, Gs^Fp, Gg, Gg, Gg, Ww, Re, Re, Gg, Gg, Gg, Gg, Gg, Gg, Aa
Gg, Gs, Gg, Gg, Aa, Rra, Ch, Gs^Fp, Hh, Ha, Aa^Fpa, Ch, Rr, Rp, Gs, Gll, Gg, Gs^Fp, Gs^Fp, Gs^Fp, Hh, Gg^Em, Rp, Rr, Gs^Fp, Gs^Fp, Aa, Aa, Aa^Fpa, Gg, Gg, Gs, Ww, Gll^Fp, Gg, Gll, Aa, Aa, Aa, Aa, Aa, Aa
Rra, Rra, Rra, Aa^Vha, Gg, Rra, Rra, Aa^Fpa, Hh^Es, Aa^Fpa, Rp, Rp, Gg, Ha, Ha, Gg, Gs, Gg, Gs^Fp, Gs^Fp, Hh, Hh, Rr, Hh, Aa^Fpa, Hh, Ha, Aa^Fpa, Aa^Fpa, Gg, Aa, Ww, Gg, Gg, Gg, Gg, Ha, Ha, Ha, Aa, Aa, Aa
Ha, Ha^Es, Ha, Rra, Rra, Gg, Rra, Gs^Fp, Gs^Fp, Rr, Gg, Gs^Fp, Gg, Gg, Ch, Aa^Fpa, Gg, Gg, Gg, Gs^Fp, Gg, Rr, Gg, Ha, Ha, Hh, Ha, Ha, Ha, Aa, Aa^Esa, Ww, Gg, Gs, Gs^Fp, Hh, Ha, Ha^Edb, Ha, Gg, Gg, Gg
Ha, Ha, Ms^Xm, Ha, Ha^Edb, Aa, Rra, Cha, Ch, Ch, Gs^Fp, Hh, Hh, Hh, Gg, Gll, Aa, Aa, Aa^Esa, Aa, Rra, Rra, Aa, Gs^Fp, Gs^Fp, Gg, Hh, Ms^Xm, Ms^Xm, Hh, Hh, Ai, Hh, Ha, Hh, Hh, Ha^Es, Ha, Hh, Gg, Gg, Gg
Ha, Ms, Ms, Ms, Ha, Aa, Rra, Ch^Ebn, 1 Kva, Cha, Mm, Gs^Fp, Hh, Hh, Gg, Gs, Rra, Rra, Rra, Rra, Aa^Fpa, Aa^Fpa, Aa^Fpa, Gg, Gg^Vh, Hh, Ha, Ms, Ms, Ms, Ww, Ww, Ms^Xm, Ms, Hh, Ha, Cvr, Gs^Fp, Gg^Ve, Gs^Fp, Aa^Fpa, Gs^Fp
Ha, Ms^Xm, Ms, Ms^Xm, Ms, Rra, Cha, Cha, Cha, Gs^Fp, Gs^Fp, Gs^Em, Gg^Ve, Gs^Fp, Aa, Rra, Aa, Aa, Aa^Fpa, Aa^Fpa, Aa^Fpa, Aa^Vea, Aa^Fpa, Gg, Aa, Gg, Aa^Fpa, Hh, Ms^Xm, Ww, Ai, Ms, Ms^Xm, Ms, Hh, Cvr^Ecf, 3 Kvr, Cvr, Gs^Fp, Gs^Fp, Aa^Fpa, Aa^Fpa
Ha, Ms, Ms, Ms, Ms, Rra, Rra, Rra, Rra, Gs^Fp, Gs^Fp, Gs^Fp, Aa^Fpa, Aa^Fpa, Aa^Fpa, Rra, Aa^Esa, Aa, Aa^Fpa, Aa^Fpa, Aa^Feta, Aa^Fpa, Aa^Fpa, Aa^Esa, Aa, Aa, Aa^Fpa, Hh, Ms, Ww, Ww, Ww, Ai, Ms^Xm, Ms^Xm, Cvr, Aa^Fpa, Aa^Fpa, Gs^Fp, Gs^Fp, Aa^Fpa, Aa^Fpa
Ms^Xm, Ms^Xm, Ms, Ms^Xm, Ms, Ha^Es, Rra, Aa, Aa, Rra, Gs^Fp, Gs^Fp, Aa^Fpa, Aa, Rra, Rra, Aa, Aa, Aa^Fpa, Aa^Esa, Ha, Aa^Fpa, Aa^Fpa, Aa, Aa^Esa, Aa^Fpa, Hh, Ms, Ai, Ai, Ai, Ww, Ms, Ms, Hh, Hh, Aa^Fpa, Cvr, Aa^Fpa, Gs^Fp, Gs^Fp, Aa^Fpa
Ms^Xm, Ha^Edb, Ms^Xm, Ms^Xm, Ms, Ms^Xm, Aa, Rra, Rra, Rra, Rra, Aa, Aa, Aa, Rra, Aa, Gg, Aa, Aa^Fpa, Aa^Fpa, Aa^Fpa, Aa^Fpa, Aa, Aa, Aa, Aa^Fpa, Hh, Ai, Ai, Ai, Ai, Ms, Ms^Xm, Ms, Hh, Gg^Ve, Gg, Aa^Fpa, Aa^Fpa, Gg, Gg, Gs^Fp
Ms^Xm, Ms^Xm, Ms^Xm, Ha, Ms, Ms, Aa, Aa^Esa, Aa, Rra, Rra, Rra, Rr, Aa, Aa, Aa, Gg, Aa, Aa^Fpa, Aa^Fpa, Aa^Fpa, Aa^Fpa, Aa, Aa, Aa, Aa^Fpa, Gs^Fp, Ai, Ai, Ai, Ms, Ms, Ms, Hh, Gll, Gll, Gll, Gll, Gll, Gll, Gll, Gll
